1 1 0 0 0 0 0 0 0 0 0 0 0 0 2 2
1 0 0 0 0 0 0 0 0 0 0 0 0 0 0 2
0 0 0 0 0 0 0 0 0 0 0 0 0 0 0 0
0 0 0 0 0 0 0 0 0 0 0 0 0 0 0 0
0 0 0 0 0 0 0 0 0 0 0 0 0 0 0 0
0 0 0 0 0 0 2 3 4 1 0 0 0 0 0 0
0 0 0 0 0 2 1 4 3 0 0 0 0 0 0 0
3 0 0 0 0 0 0 0 0 0 0 0 0 0 0 4
3 3 0 0 0 0 0 0 0 0 0 0 0 0 4 4